####################################################
#Sandbox#                                  PPPPPPP #
#########                                  GGGGGGG #
#                                          YYYYYYY #
#                                          TTTTTTT #
#     0                                    ******* #
#                                                  #
#                                          E     E #
####################################################