###################################################################
#Boss############################***###############################                                                            
#################################TTT###############################
#       ### GG  ### PP                         TTT                #
#  0    TT      TTT                            TTT                E
#       ### GG  ### PP                         TTT                #
###################################################################