####################################################
# start #    T       #       T       #   # ausgang #
#########    #       #       #       #   ###########
# 0          #       #       #       #             E
#            #       T       #               T     #
####################################################